data retrieval=wyszukiwanie pobieranie danych
principles=zasady
flat file=plik płaski
assumption=założenie
referential integrity=integralność referencyjna
constraints=więzy
having that in mind=mając to na uwadze
intra-query parallelism=równoległe wykonanie części zapytania
conceptual=koncepcyjny
by and large=ogólnie rzecz biorąc
evaluation=ocena
involves=wymaga
tablespace=obszar tabeli
basis of=podstawy
maintenance=utrzymanie konserwacja
inherent=nieodłączny
accuracy=dokładny precyzyjny trafny
whereas=podczas gdy
interrelated=powiązane
common=wspólny
out of date=nieaktualne
coefficient=współczynnik
scattered=rozproszone
data marts=hurtownie danych
to distinguish=odróżnić
with respect to=odnośnie do czegoś
specify=określają
owing to=dzięki
ensure=zapewnić
consistent=spójny
